"","party","vote","sim","nao","abs","falta","obs","tot"
"1","DEM","vote.6350",1,17,0,3,0,21
"2","PCdoB","vote.6350",11,0,0,2,0,13
"3","PDT","vote.6350",0,16,0,3,0,19
"4","PEN","vote.6350",0,1,0,1,0,2
"5","PHS","vote.6350",0,5,0,0,0,5
"6","PMDB","vote.6350",2,47,0,17,0,66
"7","PMN","vote.6350",0,3,0,0,0,3
"8","PP","vote.6350",0,37,0,3,0,40
"9","PPS","vote.6350",0,8,0,3,0,11
"10","PR","vote.6350",0,27,0,7,0,34
"11","PRB","vote.6350",0,19,0,1,0,20
"12","PROS","vote.6350",0,11,0,1,0,12
"13","PRP","vote.6350",0,2,0,1,0,3
"14","PRTB","vote.6350",0,1,0,0,0,1
"15","PSB","vote.6350",1,26,0,5,0,32
"16","PSC","vote.6350",0,11,0,2,0,13
"17","PSD","vote.6350",0,24,0,10,0,34
"18","PSDB","vote.6350",0,42,1,10,0,53
"19","PSDC","vote.6350",1,1,0,0,0,2
"20","PSL","vote.6350",0,1,0,0,0,1
"21","PSOL","vote.6350",0,4,0,0,0,4
"22","PT","vote.6350",3,53,1,6,0,63
"23","PTB","vote.6350",0,23,0,2,0,25
"24","PTC","vote.6350",0,2,0,0,0,2
"25","PTdoB","vote.6350",0,2,0,0,0,2
"26","PTN","vote.6350",0,4,0,0,0,4
"27","PV","vote.6350",1,4,0,3,0,8
"28","Solidarie","vote.6350",1,11,0,6,0,18
"29",NA,"vote.6350",0,0,0,1,0,1
"30","DEM","vote.6351",9,10,0,2,0,21
"31","PCdoB","vote.6351",0,13,0,0,0,13
"32","PDT","vote.6351",0,17,0,2,0,19
"33","PEN","vote.6351",0,2,0,0,0,2
"34","PHS","vote.6351",0,4,0,1,0,5
"35","PMDB","vote.6351",8,49,0,9,0,66
"36","PMN","vote.6351",0,3,0,0,0,3
"37","PP","vote.6351",3,34,0,3,0,40
"38","PPS","vote.6351",10,0,0,1,0,11
"39","PR","vote.6351",1,30,0,3,0,34
"40","PRB","vote.6351",0,18,0,2,0,20
"41","PROS","vote.6351",5,6,0,1,0,12
"42","PRP","vote.6351",0,3,0,0,0,3
"43","PRTB","vote.6351",0,1,0,0,0,1
"44","PSB","vote.6351",0,30,0,2,0,32
"45","PSC","vote.6351",1,9,1,2,0,13
"46","PSD","vote.6351",0,29,0,5,0,34
"47","PSDB","vote.6351",48,1,0,4,0,53
"48","PSDC","vote.6351",1,1,0,0,0,2
"49","PSL","vote.6351",0,1,0,0,0,1
"50","PSOL","vote.6351",0,4,0,0,0,4
"51","PT","vote.6351",0,61,1,1,0,63
"52","PTB","vote.6351",3,21,0,1,0,25
"53","PTC","vote.6351",0,2,0,0,0,2
"54","PTdoB","vote.6351",0,2,0,0,0,2
"55","PTN","vote.6351",0,4,0,0,0,4
"56","PV","vote.6351",7,1,0,0,0,8
"57","Solidarie","vote.6351",3,12,0,3,0,18
"58",NA,"vote.6351",0,0,0,1,0,1
"59","DEM","vote.6352",15,4,0,2,0,21
"60","PCdoB","vote.6352",13,0,0,0,0,13
"61","PDT","vote.6352",0,17,1,1,0,19
"62","PEN","vote.6352",2,0,0,0,0,2
"63","PHS","vote.6352",5,0,0,0,0,5
"64","PMDB","vote.6352",48,13,0,5,0,66
"65","PMN","vote.6352",1,2,0,0,0,3
"66","PP","vote.6352",34,4,0,2,0,40
"67","PPS","vote.6352",1,9,0,1,0,11
"68","PR","vote.6352",0,31,0,3,0,34
"69","PRB","vote.6352",0,20,0,0,0,20
"70","PROS","vote.6352",4,8,0,0,0,12
"71","PRP","vote.6352",2,1,0,0,0,3
"72","PRTB","vote.6352",1,0,0,0,0,1
"73","PSB","vote.6352",5,25,0,2,0,32
"74","PSC","vote.6352",8,3,0,2,0,13
"75","PSD","vote.6352",13,16,0,5,0,34
"76","PSDB","vote.6352",21,26,2,4,0,53
"77","PSDC","vote.6352",1,1,0,0,0,2
"78","PSL","vote.6352",1,0,0,0,0,1
"79","PSOL","vote.6352",0,4,0,0,0,4
"80","PT","vote.6352",0,62,1,0,0,63
"81","PTB","vote.6352",21,3,0,1,0,25
"82","PTC","vote.6352",0,2,0,0,0,2
"83","PTdoB","vote.6352",0,2,0,0,0,2
"84","PTN","vote.6352",1,3,0,0,0,4
"85","PV","vote.6352",3,5,0,0,0,8
"86","Solidarie","vote.6352",10,6,1,1,0,18
"87",NA,"vote.6352",0,0,0,1,0,1
"88","DEM","vote.6354",14,5,0,2,0,21
"89","PCdoB","vote.6354",0,13,0,0,0,13
"90","PDT","vote.6354",1,16,0,2,0,19
"91","PEN","vote.6354",2,0,0,0,0,2
"92","PHS","vote.6354",4,1,0,0,0,5
"93","PMDB","vote.6354",46,13,1,6,0,66
"94","PMN","vote.6354",1,2,0,0,0,3
"95","PP","vote.6354",26,8,0,6,0,40
"96","PPS","vote.6354",0,10,0,1,0,11
"97","PR","vote.6354",27,4,0,3,0,34
"98","PRB","vote.6354",2,18,0,0,0,20
"99","PROS","vote.6354",3,9,0,0,0,12
"100","PRP","vote.6354",2,1,0,0,0,3
"101","PRTB","vote.6354",0,1,0,0,0,1
"102","PSB","vote.6354",16,14,0,2,0,32
"103","PSC","vote.6354",6,5,0,2,0,13
"104","PSD","vote.6354",26,3,0,5,0,34
"105","PSDB","vote.6354",46,1,2,4,0,53
"106","PSDC","vote.6354",1,1,0,0,0,2
"107","PSL","vote.6354",0,1,0,0,0,1
"108","PSOL","vote.6354",0,4,0,0,0,4
"109","PT","vote.6354",0,62,1,0,0,63
"110","PTB","vote.6354",23,0,0,2,0,25
"111","PTC","vote.6354",0,2,0,0,0,2
"112","PTdoB","vote.6354",0,2,0,0,0,2
"113","PTN","vote.6354",1,3,0,0,0,4
"114","PV","vote.6354",3,5,0,0,0,8
"115","Solidarie","vote.6354",14,3,0,1,0,18
"116",NA,"vote.6354",0,0,0,1,0,1
"117","DEM","vote.6356",0,0,17,4,0,21
"118","PCdoB","vote.6356",13,0,0,0,0,13
"119","PDT","vote.6356",17,0,0,2,0,19
"120","PEN","vote.6356",0,2,0,0,0,2
"121","PHS","vote.6356",0,5,0,0,0,5
"122","PMDB","vote.6356",8,50,1,7,0,66
"123","PMN","vote.6356",0,3,0,0,0,3
"124","PP","vote.6356",6,30,2,2,0,40
"125","PPS","vote.6356",11,0,0,0,0,11
"126","PR","vote.6356",3,27,0,4,0,34
"127","PRB","vote.6356",0,17,0,3,0,20
"128","PROS","vote.6356",6,6,0,0,0,12
"129","PRP","vote.6356",0,3,0,0,0,3
"130","PRTB","vote.6356",0,1,0,0,0,1
"131","PSB","vote.6356",20,10,1,1,0,32
"132","PSC","vote.6356",1,11,0,1,0,13
"133","PSD","vote.6356",2,28,0,4,0,34
"134","PSDB","vote.6356",0,3,42,8,0,53
"135","PSDC","vote.6356",0,2,0,0,0,2
"136","PSL","vote.6356",0,1,0,0,0,1
"137","PSOL","vote.6356",4,0,0,0,0,4
"138","PT","vote.6356",62,0,1,0,0,63
"139","PTB","vote.6356",0,20,1,4,0,25
"140","PTC","vote.6356",0,1,0,1,0,2
"141","PTdoB","vote.6356",0,2,0,0,0,2
"142","PTN","vote.6356",3,1,0,0,0,4
"143","PV","vote.6356",4,4,0,0,0,8
"144","Solidarie","vote.6356",3,13,1,1,0,18
"145",NA,"vote.6356",1,0,0,0,0,1
"146","DEM","vote.6357",0,16,0,5,0,21
"147","PCdoB","vote.6357",11,0,0,2,0,13
"148","PDT","vote.6357",10,2,4,3,0,19
"149","PEN","vote.6357",0,2,0,0,0,2
"150","PHS","vote.6357",0,5,0,0,0,5
"151","PMDB","vote.6357",5,55,0,6,0,66
"152","PMN","vote.6357",0,3,0,0,0,3
"153","PP","vote.6357",4,31,1,4,0,40
"154","PPS","vote.6357",1,10,0,0,0,11
"155","PR","vote.6357",2,25,0,7,0,34
"156","PRB","vote.6357",0,20,0,0,0,20
"157","PROS","vote.6357",0,11,0,1,0,12
"158","PRP","vote.6357",0,3,0,0,0,3
"159","PRTB","vote.6357",0,1,0,0,0,1
"160","PSB","vote.6357",5,25,0,2,0,32
"161","PSC","vote.6357",0,12,0,1,0,13
"162","PSD","vote.6357",1,29,0,4,0,34
"163","PSDB","vote.6357",0,41,2,10,0,53
"164","PSDC","vote.6357",0,2,0,0,0,2
"165","PSL","vote.6357",0,1,0,0,0,1
"166","PSOL","vote.6357",3,0,0,1,0,4
"167","PT","vote.6357",12,1,48,2,0,63
"168","PTB","vote.6357",0,22,0,3,0,25
"169","PTC","vote.6357",0,1,0,1,0,2
"170","PTdoB","vote.6357",0,2,0,0,0,2
"171","PTN","vote.6357",0,4,0,0,0,4
"172","PV","vote.6357",0,7,0,1,0,8
"173","Solidarie","vote.6357",1,12,3,2,0,18
"174",NA,"vote.6357",1,0,0,0,0,1
"175","DEM","vote.6358",20,0,0,1,0,21
"176","PCdoB","vote.6358",0,13,0,0,0,13
"177","PDT","vote.6358",2,14,0,3,0,19
"178","PEN","vote.6358",2,0,0,0,0,2
"179","PHS","vote.6358",5,0,0,0,0,5
"180","PMDB","vote.6358",56,4,0,6,0,66
"181","PMN","vote.6358",3,0,0,0,0,3
"182","PP","vote.6358",32,5,0,3,0,40
"183","PPS","vote.6358",0,11,0,0,0,11
"184","PR","vote.6358",27,2,0,5,0,34
"185","PRB","vote.6358",20,0,0,0,0,20
"186","PROS","vote.6358",5,7,0,0,0,12
"187","PRP","vote.6358",3,0,0,0,0,3
"188","PRTB","vote.6358",1,0,0,0,0,1
"189","PSB","vote.6358",16,14,0,2,0,32
"190","PSC","vote.6358",11,1,0,1,0,13
"191","PSD","vote.6358",29,1,0,4,0,34
"192","PSDB","vote.6358",46,1,0,6,0,53
"193","PSDC","vote.6358",2,0,0,0,0,2
"194","PSL","vote.6358",1,0,0,0,0,1
"195","PSOL","vote.6358",0,0,0,0,4,4
"196","PT","vote.6358",0,62,1,0,0,63
"197","PTB","vote.6358",24,0,0,1,0,25
"198","PTC","vote.6358",1,0,0,1,0,2
"199","PTdoB","vote.6358",2,0,0,0,0,2
"200","PTN","vote.6358",2,2,0,0,0,4
"201","PV","vote.6358",6,2,0,0,0,8
"202","Solidarie","vote.6358",14,1,0,3,0,18
"203",NA,"vote.6358",0,1,0,0,0,1
"204","DEM","vote.6359",15,5,0,1,0,21
"205","PCdoB","vote.6359",13,0,0,0,0,13
"206","PDT","vote.6359",16,1,0,2,0,19
"207","PEN","vote.6359",1,0,0,1,0,2
"208","PHS","vote.6359",4,0,0,1,0,5
"209","PMDB","vote.6359",57,3,0,6,0,66
"210","PMN","vote.6359",3,0,0,0,0,3
"211","PP","vote.6359",34,0,0,6,0,40
"212","PPS","vote.6359",10,1,0,0,0,11
"213","PR","vote.6359",30,0,0,4,0,34
"214","PRB","vote.6359",20,0,0,0,0,20
"215","PROS","vote.6359",12,0,0,0,0,12
"216","PRP","vote.6359",3,0,0,0,0,3
"217","PRTB","vote.6359",1,0,0,0,0,1
"218","PSB","vote.6359",29,1,0,2,0,32
"219","PSC","vote.6359",12,0,0,1,0,13
"220","PSD","vote.6359",30,0,0,4,0,34
"221","PSDB","vote.6359",45,1,0,7,0,53
"222","PSDC","vote.6359",2,0,0,0,0,2
"223","PSL","vote.6359",1,0,0,0,0,1
"224","PSOL","vote.6359",4,0,0,0,0,4
"225","PT","vote.6359",59,3,1,0,0,63
"226","PTB","vote.6359",21,3,0,1,0,25
"227","PTC","vote.6359",1,0,0,1,0,2
"228","PTdoB","vote.6359",2,0,0,0,0,2
"229","PTN","vote.6359",4,0,0,0,0,4
"230","PV","vote.6359",7,0,0,1,0,8
"231","Solidarie","vote.6359",15,1,0,2,0,18
"232",NA,"vote.6359",1,0,0,0,0,1
"233","DEM","vote.6360",0,8,0,13,0,21
"234","PCdoB","vote.6360",0,10,0,3,0,13
"235","PDT","vote.6360",0,8,0,11,0,19
"236","PEN","vote.6360",0,2,0,0,0,2
"237","PHS","vote.6360",0,2,0,3,0,5
"238","PMDB","vote.6360",1,30,0,35,0,66
"239","PMN","vote.6360",0,2,0,1,0,3
"240","PP","vote.6360",1,22,0,17,0,40
"241","PPS","vote.6360",0,6,0,5,0,11
"242","PR","vote.6360",0,16,0,18,0,34
"243","PRB","vote.6360",0,9,0,11,0,20
"244","PROS","vote.6360",1,6,0,5,0,12
"245","PRP","vote.6360",0,0,0,3,0,3
"246","PRTB","vote.6360",0,1,0,0,0,1
"247","PSB","vote.6360",0,16,0,16,0,32
"248","PSC","vote.6360",0,5,0,8,0,13
"249","PSD","vote.6360",0,17,0,17,0,34
"250","PSDB","vote.6360",0,31,0,22,0,53
"251","PSDC","vote.6360",0,1,0,1,0,2
"252","PSL","vote.6360",0,1,0,0,0,1
"253","PSOL","vote.6360",2,0,0,2,0,4
"254","PT","vote.6360",31,0,0,32,0,63
"255","PTB","vote.6360",0,13,0,12,0,25
"256","PTC","vote.6360",1,0,0,1,0,2
"257","PTdoB","vote.6360",0,0,0,2,0,2
"258","PTN","vote.6360",0,3,0,1,0,4
"259","PV","vote.6360",0,4,0,4,0,8
"260","Solidarie","vote.6360",0,6,0,12,0,18
"261",NA,"vote.6360",1,0,0,0,0,1
"262","DEM","vote.6362",11,8,0,2,0,21
"263","PCdoB","vote.6362",0,13,0,0,0,13
"264","PDT","vote.6362",10,5,0,4,0,19
"265","PEN","vote.6362",0,2,0,0,0,2
"266","PHS","vote.6362",0,5,0,0,0,5
"267","PMDB","vote.6362",37,18,1,10,0,66
"268","PMN","vote.6362",0,2,0,1,0,3
"269","PP","vote.6362",12,23,0,5,0,40
"270","PPS","vote.6362",9,1,0,1,0,11
"271","PR","vote.6362",1,29,0,4,0,34
"272","PRB","vote.6362",1,18,0,1,0,20
"273","PROS","vote.6362",5,6,0,1,0,12
"274","PRP","vote.6362",0,2,0,1,0,3
"275","PRTB","vote.6362",0,1,0,0,0,1
"276","PSB","vote.6362",25,2,1,4,0,32
"277","PSC","vote.6362",1,10,0,2,0,13
"278","PSD","vote.6362",23,5,0,6,0,34
"279","PSDB","vote.6362",43,0,2,8,0,53
"280","PSDC","vote.6362",0,2,0,0,0,2
"281","PSL","vote.6362",0,1,0,0,0,1
"282","PSOL","vote.6362",4,0,0,0,0,4
"283","PT","vote.6362",16,44,1,2,0,63
"284","PTB","vote.6362",5,14,0,6,0,25
"285","PTC","vote.6362",0,1,0,1,0,2
"286","PTdoB","vote.6362",0,2,0,0,0,2
"287","PTN","vote.6362",0,4,0,0,0,4
"288","PV","vote.6362",2,5,0,1,0,8
"289","Solidarie","vote.6362",0,13,0,5,0,18
"290",NA,"vote.6362",1,0,0,0,0,1
"291","DEM","vote.6363",17,1,0,3,0,21
"292","PCdoB","vote.6363",13,0,0,0,0,13
"293","PDT","vote.6363",13,0,2,4,0,19
"294","PEN","vote.6363",2,0,0,0,0,2
"295","PHS","vote.6363",5,0,0,0,0,5
"296","PMDB","vote.6363",50,5,0,11,0,66
"297","PMN","vote.6363",2,0,0,1,0,3
"298","PP","vote.6363",24,9,0,7,0,40
"299","PPS","vote.6363",11,0,0,0,0,11
"300","PR","vote.6363",30,1,0,3,0,34
"301","PRB","vote.6363",19,0,0,1,0,20
"302","PROS","vote.6363",8,3,0,1,0,12
"303","PRP","vote.6363",3,0,0,0,0,3
"304","PRTB","vote.6363",1,0,0,0,0,1
"305","PSB","vote.6363",12,16,0,4,0,32
"306","PSC","vote.6363",9,1,0,3,0,13
"307","PSD","vote.6363",26,2,0,6,0,34
"308","PSDB","vote.6363",13,0,1,12,27,53
"309","PSDC","vote.6363",2,0,0,0,0,2
"310","PSL","vote.6363",1,0,0,0,0,1
"311","PSOL","vote.6363",4,0,0,0,0,4
"312","PT","vote.6363",57,0,2,4,0,63
"313","PTB","vote.6363",19,1,0,5,0,25
"314","PTC","vote.6363",1,0,0,1,0,2
"315","PTdoB","vote.6363",2,0,0,0,0,2
"316","PTN","vote.6363",4,0,0,0,0,4
"317","PV","vote.6363",7,0,0,1,0,8
"318","Solidarie","vote.6363",13,0,0,5,0,18
"319",NA,"vote.6363",1,0,0,0,0,1
"320","DEM","vote.6368",10,7,0,4,0,21
"321","PCdoB","vote.6368",0,10,0,3,0,13
"322","PDT","vote.6368",1,12,0,6,0,19
"323","PEN","vote.6368",1,0,0,1,0,2
"324","PHS","vote.6368",1,4,0,0,0,5
"325","PMDB","vote.6368",39,7,0,19,0,66
"326","PMN","vote.6368",0,3,0,0,0,3
"327","PP","vote.6368",21,11,0,8,0,40
"328","PPS","vote.6368",0,10,0,1,0,11
"329","PR","vote.6368",0,26,0,8,0,34
"330","PRB","vote.6368",0,12,0,8,0,20
"331","PROS","vote.6368",1,7,0,4,0,12
"332","PRP","vote.6368",0,3,0,0,0,3
"333","PRTB","vote.6368",1,0,0,0,0,1
"334","PSB","vote.6368",7,21,0,4,0,32
"335","PSC","vote.6368",5,3,0,5,0,13
"336","PSD","vote.6368",8,14,0,12,0,34
"337","PSDB","vote.6368",2,38,1,12,0,53
"338","PSDC","vote.6368",1,1,0,0,0,2
"339","PSL","vote.6368",0,1,0,0,0,1
"340","PSOL","vote.6368",0,4,0,0,0,4
"341","PT","vote.6368",0,50,1,12,0,63
"342","PTB","vote.6368",12,7,0,6,0,25
"343","PTC","vote.6368",1,1,0,0,0,2
"344","PTdoB","vote.6368",0,0,0,2,0,2
"345","PTN","vote.6368",0,4,0,0,0,4
"346","PV","vote.6368",3,0,0,5,0,8
"347","Solidarie","vote.6368",0,11,0,7,0,18
"348",NA,"vote.6368",0,1,0,0,0,1
"349","DEM","vote.6369",20,1,0,0,0,21
"350","PCdoB","vote.6369",1,11,0,1,0,13
"351","PDT","vote.6369",2,13,1,3,0,19
"352","PEN","vote.6369",1,1,0,0,0,2
"353","PHS","vote.6369",0,5,0,0,0,5
"354","PMDB","vote.6369",30,26,0,9,0,66
"355","PMN","vote.6369",1,2,0,0,0,3
"356","PP","vote.6369",8,22,0,10,0,40
"357","PPS","vote.6369",9,2,0,0,0,11
"358","PR","vote.6369",2,25,0,7,0,34
"359","PRB","vote.6369",3,14,0,3,0,20
"360","PROS","vote.6369",2,5,0,5,0,12
"361","PRP","vote.6369",1,2,0,0,0,3
"362","PRTB","vote.6369",0,1,0,0,0,1
"363","PSB","vote.6369",3,27,0,2,0,32
"364","PSC","vote.6369",6,3,1,3,0,13
"365","PSD","vote.6369",10,20,0,4,0,34
"366","PSDB","vote.6369",18,33,0,2,0,53
"367","PSDC","vote.6369",1,1,0,0,0,2
"368","PSL","vote.6369",0,1,0,0,0,1
"369","PSOL","vote.6369",0,4,0,0,0,4
"370","PT","vote.6369",0,61,1,1,0,63
"371","PTB","vote.6369",6,14,0,5,0,25
"372","PTC","vote.6369",0,2,0,0,0,2
"373","PTdoB","vote.6369",0,2,0,0,0,2
"374","PTN","vote.6369",0,4,0,0,0,4
"375","PV","vote.6369",4,3,0,1,0,8
"376","Solidarie","vote.6369",5,6,0,7,0,18
"377",NA,"vote.6369",1,0,0,0,0,1
"378","DEM","vote.6370",5,15,0,1,0,21
"379","PCdoB","vote.6370",0,13,0,0,0,13
"380","PDT","vote.6370",14,1,1,3,0,19
"381","PEN","vote.6370",2,0,0,0,0,2
"382","PHS","vote.6370",5,0,0,0,0,5
"383","PMDB","vote.6370",49,7,0,9,0,66
"384","PMN","vote.6370",1,2,0,0,0,3
"385","PP","vote.6370",30,4,0,6,0,40
"386","PPS","vote.6370",0,11,0,0,0,11
"387","PR","vote.6370",29,1,0,4,0,34
"388","PRB","vote.6370",5,12,0,3,0,20
"389","PROS","vote.6370",6,3,0,3,0,12
"390","PRP","vote.6370",2,1,0,0,0,3
"391","PRTB","vote.6370",1,0,0,0,0,1
"392","PSB","vote.6370",29,1,0,2,0,32
"393","PSC","vote.6370",8,3,0,2,0,13
"394","PSD","vote.6370",27,3,0,4,0,34
"395","PSDB","vote.6370",34,16,1,2,0,53
"396","PSDC","vote.6370",0,2,0,0,0,2
"397","PSL","vote.6370",1,0,0,0,0,1
"398","PSOL","vote.6370",4,0,0,0,0,4
"399","PT","vote.6370",62,0,1,0,0,63
"400","PTB","vote.6370",14,7,0,4,0,25
"401","PTC","vote.6370",0,2,0,0,0,2
"402","PTdoB","vote.6370",1,1,0,0,0,2
"403","PTN","vote.6370",1,3,0,0,0,4
"404","PV","vote.6370",7,0,0,1,0,8
"405","Solidarie","vote.6370",11,1,0,6,0,18
"406",NA,"vote.6370",0,1,0,0,0,1
"407","DEM","vote.6371",8,11,0,2,0,21
"408","PCdoB","vote.6371",0,12,0,1,0,13
"409","PDT","vote.6371",13,2,1,3,0,19
"410","PEN","vote.6371",2,0,0,0,0,2
"411","PHS","vote.6371",0,5,0,0,0,5
"412","PMDB","vote.6371",45,10,0,10,0,66
"413","PMN","vote.6371",2,1,0,0,0,3
"414","PP","vote.6371",24,8,0,8,0,40
"415","PPS","vote.6371",0,11,0,0,0,11
"416","PR","vote.6371",19,9,1,5,0,34
"417","PRB","vote.6371",3,13,0,4,0,20
"418","PROS","vote.6371",5,4,0,3,0,12
"419","PRP","vote.6371",1,2,0,0,0,3
"420","PRTB","vote.6371",1,0,0,0,0,1
"421","PSB","vote.6371",24,4,0,4,0,32
"422","PSC","vote.6371",10,1,0,2,0,13
"423","PSD","vote.6371",16,15,0,3,0,34
"424","PSDB","vote.6371",8,40,0,5,0,53
"425","PSDC","vote.6371",1,1,0,0,0,2
"426","PSL","vote.6371",1,0,0,0,0,1
"427","PSOL","vote.6371",0,4,0,0,0,4
"428","PT","vote.6371",6,55,1,1,0,63
"429","PTB","vote.6371",15,5,0,5,0,25
"430","PTC","vote.6371",1,1,0,0,0,2
"431","PTdoB","vote.6371",0,2,0,0,0,2
"432","PTN","vote.6371",0,4,0,0,0,4
"433","PV","vote.6371",4,3,0,1,0,8
"434","Solidarie","vote.6371",11,1,0,6,0,18
"435",NA,"vote.6371",0,1,0,0,0,1
"436","DEM","vote.6372",17,0,0,4,0,21
"437","PCdoB","vote.6372",13,0,0,0,0,13
"438","PDT","vote.6372",16,0,0,3,0,19
"439","PEN","vote.6372",2,0,0,0,0,2
"440","PHS","vote.6372",5,0,0,0,0,5
"441","PMDB","vote.6372",49,2,1,13,0,66
"442","PMN","vote.6372",3,0,0,0,0,3
"443","PP","vote.6372",32,0,0,8,0,40
"444","PPS","vote.6372",11,0,0,0,0,11
"445","PR","vote.6372",23,0,0,11,0,34
"446","PRB","vote.6372",17,0,0,3,0,20
"447","PROS","vote.6372",7,0,0,5,0,12
"448","PRP","vote.6372",1,2,0,0,0,3
"449","PRTB","vote.6372",1,0,0,0,0,1
"450","PSB","vote.6372",29,0,0,3,0,32
"451","PSC","vote.6372",9,0,1,3,0,13
"452","PSD","vote.6372",29,1,0,4,0,34
"453","PSDB","vote.6372",47,1,1,4,0,53
"454","PSDC","vote.6372",2,0,0,0,0,2
"455","PSL","vote.6372",1,0,0,0,0,1
"456","PSOL","vote.6372",4,0,0,0,0,4
"457","PT","vote.6372",56,1,1,5,0,63
"458","PTB","vote.6372",19,1,0,5,0,25
"459","PTC","vote.6372",2,0,0,0,0,2
"460","PTdoB","vote.6372",2,0,0,0,0,2
"461","PTN","vote.6372",4,0,0,0,0,4
"462","PV","vote.6372",6,0,0,2,0,8
"463","Solidarie","vote.6372",11,0,0,7,0,18
"464",NA,"vote.6372",1,0,0,0,0,1
"465","DEM","vote.6373",12,5,0,4,0,21
"466","PCdoB","vote.6373",10,0,0,3,0,13
"467","PDT","vote.6373",14,0,0,5,0,19
"468","PEN","vote.6373",1,0,0,1,0,2
"469","PHS","vote.6373",5,0,0,0,0,5
"470","PMDB","vote.6373",44,7,0,14,0,66
"471","PMN","vote.6373",3,0,0,0,0,3
"472","PP","vote.6373",26,6,0,8,0,40
"473","PPS","vote.6373",11,0,0,0,0,11
"474","PR","vote.6373",24,2,1,7,0,34
"475","PRB","vote.6373",9,8,0,3,0,20
"476","PROS","vote.6373",6,2,0,4,0,12
"477","PRP","vote.6373",2,0,0,1,0,3
"478","PRTB","vote.6373",1,0,0,0,0,1
"479","PSB","vote.6373",22,5,0,5,0,32
"480","PSC","vote.6373",5,6,0,2,0,13
"481","PSD","vote.6373",22,7,0,5,0,34
"482","PSDB","vote.6373",31,14,0,8,0,53
"483","PSDC","vote.6373",1,1,0,0,0,2
"484","PSL","vote.6373",1,0,0,0,0,1
"485","PSOL","vote.6373",4,0,0,0,0,4
"486","PT","vote.6373",49,0,1,13,0,63
"487","PTB","vote.6373",16,2,0,7,0,25
"488","PTC","vote.6373",1,1,0,0,0,2
"489","PTdoB","vote.6373",1,0,0,1,0,2
"490","PTN","vote.6373",1,3,0,0,0,4
"491","PV","vote.6373",4,3,0,1,0,8
"492","Solidarie","vote.6373",10,1,0,7,0,18
"493",NA,"vote.6373",1,0,0,0,0,1
"494","DEM","vote.6374",14,3,0,4,0,21
"495","PCdoB","vote.6374",8,0,0,5,0,13
"496","PDT","vote.6374",6,8,0,5,0,19
"497","PEN","vote.6374",2,0,0,0,0,2
"498","PHS","vote.6374",5,0,0,0,0,5
"499","PMDB","vote.6374",48,5,0,13,0,66
"500","PMN","vote.6374",3,0,0,0,0,3
"501","PP","vote.6374",28,4,0,8,0,40
"502","PPS","vote.6374",9,0,0,2,0,11
"503","PR","vote.6374",20,4,0,10,0,34
"504","PRB","vote.6374",12,5,0,3,0,20
"505","PROS","vote.6374",7,1,0,4,0,12
"506","PRP","vote.6374",3,0,0,0,0,3
"507","PRTB","vote.6374",1,0,0,0,0,1
"508","PSB","vote.6374",23,6,0,3,0,32
"509","PSC","vote.6374",8,3,0,2,0,13
"510","PSD","vote.6374",31,0,0,3,0,34
"511","PSDB","vote.6374",43,2,0,8,0,53
"512","PSDC","vote.6374",1,1,0,0,0,2
"513","PSL","vote.6374",1,0,0,0,0,1
"514","PSOL","vote.6374",4,0,0,0,0,4
"515","PT","vote.6374",47,0,1,15,0,63
"516","PTB","vote.6374",17,1,0,7,0,25
"517","PTC","vote.6374",2,0,0,0,0,2
"518","PTdoB","vote.6374",2,0,0,0,0,2
"519","PTN","vote.6374",2,2,0,0,0,4
"520","PV","vote.6374",4,3,0,1,0,8
"521","Solidarie","vote.6374",11,0,0,7,0,18
"522",NA,"vote.6374",1,0,0,0,0,1
"523","DEM","vote.6375",18,0,0,3,0,21
"524","PCdoB","vote.6375",8,0,0,5,0,13
"525","PDT","vote.6375",14,0,0,5,0,19
"526","PEN","vote.6375",2,0,0,0,0,2
"527","PHS","vote.6375",5,0,0,0,0,5
"528","PMDB","vote.6375",51,0,0,15,0,66
"529","PMN","vote.6375",3,0,0,0,0,3
"530","PP","vote.6375",27,5,0,8,0,40
"531","PPS","vote.6375",11,0,0,0,0,11
"532","PR","vote.6375",25,0,0,9,0,34
"533","PRB","vote.6375",16,0,0,4,0,20
"534","PROS","vote.6375",8,0,0,4,0,12
"535","PRP","vote.6375",3,0,0,0,0,3
"536","PRTB","vote.6375",1,0,0,0,0,1
"537","PSB","vote.6375",26,2,0,4,0,32
"538","PSC","vote.6375",10,0,0,3,0,13
"539","PSD","vote.6375",28,1,0,5,0,34
"540","PSDB","vote.6375",43,1,0,9,0,53
"541","PSDC","vote.6375",2,0,0,0,0,2
"542","PSL","vote.6375",1,0,0,0,0,1
"543","PSOL","vote.6375",3,0,0,1,0,4
"544","PT","vote.6375",37,1,9,16,0,63
"545","PTB","vote.6375",18,0,0,7,0,25
"546","PTC","vote.6375",2,0,0,0,0,2
"547","PTdoB","vote.6375",2,0,0,0,0,2
"548","PTN","vote.6375",4,0,0,0,0,4
"549","PV","vote.6375",6,0,0,2,0,8
"550","Solidarie","vote.6375",11,0,0,7,0,18
"551",NA,"vote.6375",1,0,0,0,0,1
"552","DEM","vote.6377",7,4,7,3,0,21
"553","PCdoB","vote.6377",11,0,0,2,0,13
"554","PDT","vote.6377",16,0,2,1,0,19
"555","PEN","vote.6377",1,0,0,1,0,2
"556","PHS","vote.6377",0,5,0,0,0,5
"557","PMDB","vote.6377",39,14,0,13,0,66
"558","PMN","vote.6377",1,0,0,2,0,3
"559","PP","vote.6377",17,12,3,8,0,40
"560","PPS","vote.6377",10,0,0,1,0,11
"561","PR","vote.6377",16,8,7,3,0,34
"562","PRB","vote.6377",8,8,1,3,0,20
"563","PROS","vote.6377",5,6,1,0,0,12
"564","PRP","vote.6377",2,1,0,0,0,3
"565","PRTB","vote.6377",1,0,0,0,0,1
"566","PSB","vote.6377",22,7,1,2,0,32
"567","PSC","vote.6377",7,3,1,2,0,13
"568","PSD","vote.6377",15,8,6,5,0,34
"569","PSDB","vote.6377",22,12,17,2,0,53
"570","PSDC","vote.6377",1,1,0,0,0,2
"571","PSL","vote.6377",1,0,0,0,0,1
"572","PSOL","vote.6377",4,0,0,0,0,4
"573","PT","vote.6377",56,0,1,6,0,63
"574","PTB","vote.6377",12,7,2,4,0,25
"575","PTC","vote.6377",1,0,0,1,0,2
"576","PTdoB","vote.6377",1,1,0,0,0,2
"577","PTN","vote.6377",2,2,0,0,0,4
"578","PV","vote.6377",6,0,0,2,0,8
"579","Solidarie","vote.6377",9,2,4,3,0,18
"580",NA,"vote.6377",0,0,0,1,0,1
"581","DEM","vote.6378",19,0,0,2,0,21
"582","PCdoB","vote.6378",10,0,0,3,0,13
"583","PDT","vote.6378",19,0,0,0,0,19
"584","PEN","vote.6378",1,0,0,1,0,2
"585","PHS","vote.6378",4,0,0,1,0,5
"586","PMDB","vote.6378",50,2,0,14,0,66
"587","PMN","vote.6378",1,1,0,1,0,3
"588","PP","vote.6378",32,0,0,8,0,40
"589","PPS","vote.6378",9,0,1,1,0,11
"590","PR","vote.6378",32,0,0,2,0,34
"591","PRB","vote.6378",17,0,0,3,0,20
"592","PROS","vote.6378",11,0,0,1,0,12
"593","PRP","vote.6378",2,1,0,0,0,3
"594","PRTB","vote.6378",1,0,0,0,0,1
"595","PSB","vote.6378",29,0,0,3,0,32
"596","PSC","vote.6378",11,0,0,2,0,13
"597","PSD","vote.6378",32,0,0,2,0,34
"598","PSDB","vote.6378",49,1,0,3,0,53
"599","PSDC","vote.6378",1,1,0,0,0,2
"600","PSL","vote.6378",1,0,0,0,0,1
"601","PSOL","vote.6378",4,0,0,0,0,4
"602","PT","vote.6378",50,1,1,11,0,63
"603","PTB","vote.6378",21,0,0,4,0,25
"604","PTC","vote.6378",1,0,0,1,0,2
"605","PTdoB","vote.6378",1,0,0,1,0,2
"606","PTN","vote.6378",3,0,0,1,0,4
"607","PV","vote.6378",7,0,0,1,0,8
"608","Solidarie","vote.6378",15,0,0,3,0,18
"609",NA,"vote.6378",0,0,0,1,0,1
"610","DEM","vote.6379",13,5,0,3,0,21
"611","PCdoB","vote.6379",11,0,0,2,0,13
"612","PDT","vote.6379",0,19,0,0,0,19
"613","PEN","vote.6379",0,1,0,1,0,2
"614","PHS","vote.6379",0,5,0,0,0,5
"615","PMDB","vote.6379",16,35,1,14,0,66
"616","PMN","vote.6379",0,2,0,1,0,3
"617","PP","vote.6379",3,29,0,8,0,40
"618","PPS","vote.6379",9,0,1,1,0,11
"619","PR","vote.6379",4,25,1,4,0,34
"620","PRB","vote.6379",0,17,0,3,0,20
"621","PROS","vote.6379",9,3,0,0,0,12
"622","PRP","vote.6379",0,3,0,0,0,3
"623","PRTB","vote.6379",0,1,0,0,0,1
"624","PSB","vote.6379",2,24,1,5,0,32
"625","PSC","vote.6379",0,9,0,4,0,13
"626","PSD","vote.6379",20,10,0,4,0,34
"627","PSDB","vote.6379",0,49,0,4,0,53
"628","PSDC","vote.6379",0,2,0,0,0,2
"629","PSL","vote.6379",1,0,0,0,0,1
"630","PSOL","vote.6379",3,0,0,1,0,4
"631","PT","vote.6379",48,7,2,6,0,63
"632","PTB","vote.6379",2,19,1,3,0,25
"633","PTC","vote.6379",1,0,0,1,0,2
"634","PTdoB","vote.6379",0,2,0,0,0,2
"635","PTN","vote.6379",3,1,0,0,0,4
"636","PV","vote.6379",0,7,0,1,0,8
"637","Solidarie","vote.6379",12,2,0,4,0,18
"638",NA,"vote.6379",0,0,0,1,0,1
"639","DEM","vote.6380",1,18,0,2,0,21
"640","PCdoB","vote.6380",1,9,0,3,0,13
"641","PDT","vote.6380",1,14,0,4,0,19
"642","PEN","vote.6380",0,1,0,1,0,2
"643","PHS","vote.6380",0,3,0,2,0,5
"644","PMDB","vote.6380",12,40,0,14,0,66
"645","PMN","vote.6380",0,2,0,1,0,3
"646","PP","vote.6380",3,28,0,9,0,40
"647","PPS","vote.6380",10,0,0,1,0,11
"648","PR","vote.6380",0,25,0,9,0,34
"649","PRB","vote.6380",0,17,0,3,0,20
"650","PROS","vote.6380",0,11,0,1,0,12
"651","PRP","vote.6380",0,3,0,0,0,3
"652","PRTB","vote.6380",0,1,0,0,0,1
"653","PSB","vote.6380",10,18,1,3,0,32
"654","PSC","vote.6380",1,7,0,5,0,13
"655","PSD","vote.6380",0,29,0,5,0,34
"656","PSDB","vote.6380",10,38,0,5,0,53
"657","PSDC","vote.6380",1,1,0,0,0,2
"658","PSL","vote.6380",0,1,0,0,0,1
"659","PSOL","vote.6380",3,1,0,0,0,4
"660","PT","vote.6380",3,49,1,10,0,63
"661","PTB","vote.6380",1,17,1,6,0,25
"662","PTC","vote.6380",0,1,0,1,0,2
"663","PTdoB","vote.6380",0,2,0,0,0,2
"664","PTN","vote.6380",3,1,0,0,0,4
"665","PV","vote.6380",0,7,0,1,0,8
"666","Solidarie","vote.6380",0,13,0,5,0,18
"667",NA,"vote.6380",0,0,0,1,0,1
"668","DEM","vote.6381",0,15,0,6,0,21
"669","PCdoB","vote.6381",0,10,0,3,0,13
"670","PDT","vote.6381",0,16,2,1,0,19
"671","PEN","vote.6381",0,1,0,1,0,2
"672","PHS","vote.6381",0,2,0,3,0,5
"673","PMDB","vote.6381",0,50,0,16,0,66
"674","PMN","vote.6381",0,2,0,1,0,3
"675","PP","vote.6381",0,32,0,8,0,40
"676","PPS","vote.6381",0,10,0,1,0,11
"677","PR","vote.6381",0,23,2,9,0,34
"678","PRB","vote.6381",0,15,0,5,0,20
"679","PROS","vote.6381",0,10,0,2,0,12
"680","PRP","vote.6381",0,3,0,0,0,3
"681","PRTB","vote.6381",0,1,0,0,0,1
"682","PSB","vote.6381",0,26,3,3,0,32
"683","PSC","vote.6381",0,9,1,3,0,13
"684","PSD","vote.6381",0,27,0,7,0,34
"685","PSDB","vote.6381",0,44,0,9,0,53
"686","PSDC","vote.6381",0,2,0,0,0,2
"687","PSL","vote.6381",0,1,0,0,0,1
"688","PSOL","vote.6381",0,4,0,0,0,4
"689","PT","vote.6381",0,54,1,8,0,63
"690","PTB","vote.6381",0,20,0,5,0,25
"691","PTC","vote.6381",0,1,0,1,0,2
"692","PTdoB","vote.6381",0,2,0,0,0,2
"693","PTN","vote.6381",0,4,0,0,0,4
"694","PV","vote.6381",0,7,0,1,0,8
"695","Solidarie","vote.6381",0,13,0,5,0,18
"696",NA,"vote.6381",0,0,0,1,0,1
"697","DEM","vote.6382",13,3,1,4,0,21
"698","PCdoB","vote.6382",11,0,0,2,0,13
"699","PDT","vote.6382",19,0,0,0,0,19
"700","PEN","vote.6382",1,0,0,1,0,2
"701","PHS","vote.6382",4,0,1,0,0,5
"702","PMDB","vote.6382",50,5,0,11,0,66
"703","PMN","vote.6382",2,0,0,1,0,3
"704","PP","vote.6382",33,2,0,5,0,40
"705","PPS","vote.6382",10,0,0,1,0,11
"706","PR","vote.6382",30,0,0,4,0,34
"707","PRB","vote.6382",17,0,0,3,0,20
"708","PROS","vote.6382",9,2,1,0,0,12
"709","PRP","vote.6382",3,0,0,0,0,3
"710","PRTB","vote.6382",1,0,0,0,0,1
"711","PSB","vote.6382",27,0,2,3,0,32
"712","PSC","vote.6382",10,1,0,2,0,13
"713","PSD","vote.6382",30,1,1,2,0,34
"714","PSDB","vote.6382",40,4,4,5,0,53
"715","PSDC","vote.6382",0,2,0,0,0,2
"716","PSL","vote.6382",1,0,0,0,0,1
"717","PSOL","vote.6382",3,1,0,0,0,4
"718","PT","vote.6382",34,19,4,6,0,63
"719","PTB","vote.6382",21,1,0,3,0,25
"720","PTC","vote.6382",1,0,0,1,0,2
"721","PTdoB","vote.6382",2,0,0,0,0,2
"722","PTN","vote.6382",4,0,0,0,0,4
"723","PV","vote.6382",5,1,1,1,0,8
"724","Solidarie","vote.6382",11,1,0,6,0,18
"725",NA,"vote.6382",0,0,0,1,0,1
"726","DEM","vote.6384",11,8,0,2,0,21
"727","PCdoB","vote.6384",0,11,0,2,0,13
"728","PDT","vote.6384",17,0,1,1,0,19
"729","PEN","vote.6384",1,0,0,1,0,2
"730","PHS","vote.6384",5,0,0,0,0,5
"731","PMDB","vote.6384",49,9,0,8,0,66
"732","PMN","vote.6384",2,0,0,1,0,3
"733","PP","vote.6384",23,10,1,6,0,40
"734","PPS","vote.6384",1,10,0,0,0,11
"735","PR","vote.6384",31,1,0,2,0,34
"736","PRB","vote.6384",16,1,0,3,0,20
"737","PROS","vote.6384",11,1,0,0,0,12
"738","PRP","vote.6384",3,0,0,0,0,3
"739","PRTB","vote.6384",1,0,0,0,0,1
"740","PSB","vote.6384",13,14,2,3,0,32
"741","PSC","vote.6384",11,0,0,2,0,13
"742","PSD","vote.6384",11,19,0,4,0,34
"743","PSDB","vote.6384",36,14,1,2,0,53
"744","PSDC","vote.6384",2,0,0,0,0,2
"745","PSL","vote.6384",1,0,0,0,0,1
"746","PSOL","vote.6384",0,4,0,0,0,4
"747","PT","vote.6384",25,32,1,5,0,63
"748","PTB","vote.6384",24,0,0,1,0,25
"749","PTC","vote.6384",1,0,0,1,0,2
"750","PTdoB","vote.6384",2,0,0,0,0,2
"751","PTN","vote.6384",4,0,0,0,0,4
"752","PV","vote.6384",2,4,0,2,0,8
"753","Solidarie","vote.6384",14,0,0,4,0,18
"754",NA,"vote.6384",0,1,0,0,0,1
"755","DEM","vote.6385",6,9,0,6,0,21
"756","PCdoB","vote.6385",0,10,0,3,0,13
"757","PDT","vote.6385",1,2,0,1,15,19
"758","PEN","vote.6385",0,1,0,1,0,2
"759","PHS","vote.6385",4,1,0,0,0,5
"760","PMDB","vote.6385",8,47,1,10,0,66
"761","PMN","vote.6385",2,0,0,1,0,3
"762","PP","vote.6385",7,21,2,10,0,40
"763","PPS","vote.6385",11,0,0,0,0,11
"764","PR","vote.6385",2,25,1,6,0,34
"765","PRB","vote.6385",3,11,1,5,0,20
"766","PROS","vote.6385",2,2,1,0,7,12
"767","PRP","vote.6385",1,2,0,0,0,3
"768","PRTB","vote.6385",0,1,0,0,0,1
"769","PSB","vote.6385",3,1,0,3,25,32
"770","PSC","vote.6385",3,7,0,3,0,13
"771","PSD","vote.6385",21,5,0,8,0,34
"772","PSDB","vote.6385",2,1,0,2,48,53
"773","PSDC","vote.6385",1,1,0,0,0,2
"774","PSL","vote.6385",0,1,0,0,0,1
"775","PSOL","vote.6385",3,1,0,0,0,4
"776","PT","vote.6385",2,48,3,10,0,63
"777","PTB","vote.6385",1,21,0,3,0,25
"778","PTC","vote.6385",0,1,0,1,0,2
"779","PTdoB","vote.6385",1,1,0,0,0,2
"780","PTN","vote.6385",0,3,0,1,0,4
"781","PV","vote.6385",1,5,0,2,0,8
"782","Solidarie","vote.6385",3,2,0,5,8,18
"783",NA,"vote.6385",1,0,0,0,0,1
"784","DEM","vote.6386",1,14,0,6,0,21
"785","PCdoB","vote.6386",0,8,0,5,0,13
"786","PDT","vote.6386",0,17,0,2,0,19
"787","PEN","vote.6386",0,1,0,1,0,2
"788","PHS","vote.6386",1,2,0,2,0,5
"789","PMDB","vote.6386",0,42,0,24,0,66
"790","PMN","vote.6386",0,1,0,2,0,3
"791","PP","vote.6386",0,23,1,16,0,40
"792","PPS","vote.6386",0,9,0,2,0,11
"793","PR","vote.6386",1,28,0,5,0,34
"794","PRB","vote.6386",0,13,0,7,0,20
"795","PROS","vote.6386",0,9,0,3,0,12
"796","PRP","vote.6386",0,3,0,0,0,3
"797","PRTB","vote.6386",0,1,0,0,0,1
"798","PSB","vote.6386",0,26,0,6,0,32
"799","PSC","vote.6386",0,8,0,5,0,13
"800","PSD","vote.6386",1,17,0,16,0,34
"801","PSDB","vote.6386",0,38,0,15,0,53
"802","PSDC","vote.6386",0,2,0,0,0,2
"803","PSL","vote.6386",0,1,0,0,0,1
"804","PSOL","vote.6386",0,4,0,0,0,4
"805","PT","vote.6386",0,36,1,26,0,63
"806","PTB","vote.6386",0,12,0,13,0,25
"807","PTC","vote.6386",0,0,0,2,0,2
"808","PTdoB","vote.6386",0,2,0,0,0,2
"809","PTN","vote.6386",0,3,0,1,0,4
"810","PV","vote.6386",0,4,0,4,0,8
"811","Solidarie","vote.6386",0,9,0,9,0,18
"812",NA,"vote.6386",0,1,0,0,0,1
